a : -1  1
b : -1  1
c : -1  1
d : -1  1
e : -1  1
f : -1  1
g : -1  1
h : -1  1
i : -1  1
j :  0  1  2  3  4
